1 2 3 3 5 5 5 8 8 8 11 11 11 14 14 
1 2 3 3 17 17 17 17 17 20 20 20 20 20 20 
1 2 3 3 3 17 26 27 27 20 20 30 31 31 33 
1 2 34 34 34 17 17 27 27 37 20 30 31 38 38 
1 1 39 34 40 40 17 27 27 27 20 30 31 38 38 
1 1 39 34 44 44 17 27 45 45 20 20 20 20 47 
1 1 39 34 49 49 17 17 17 45 45 45 52 53 53 
1 1 39 39 49 54 55 56 17 17 57 57 57 53 59 
1 1 61 39 49 49 49 49 62 62 57 57 57 57 57 
65 1 61 39 66 67 49 68 69 62 62 70 71 71 73 
65 1 1 39 66 67 49 49 69 69 74 70 75 71 71 
65 65 65 39 66 67 77 49 69 69 74 70 70 70 70 
80 80 80 39 66 67 67 67 67 67 67 67 84 70 85 
80 80 80 80 80 80 80 80 90 91 92 93 93 70 85 
0 0 0 0 0 80 0 0 90 91 92 93 0 70 85 
