1 1 1 1 1 6 6 6 6 6 6 6 6 6 6 6 6 6 6 6 6 6 6 6 6 6 6 6 6 30 
31 31 31 43 43 43 43 43 43 43 43 39 39 39 39 43 43 43 43 43 43 43 43 43 43 43 43 43 43 30 
61 61 61 61 61 61 61 61 61 61 61 61 61 61 61 61 61 61 61 61 61 61 61 61 61 61 61 61 61 61 
94 94 94 94 94 94 94 94 94 94 94 94 94 94 94 94 94 94 94 94 94 93 94 94 94 94 94 94 94 94 
101 101 101 101 101 101 106 106 106 109 109 111 111 111 111 111 111 101 101 101 101 101 101 101 101 101 101 101 101 101 
137 137 137 137 137 127 127 127 127 127 127 127 127 127 127 135 135 135 137 137 137 137 137 137 137 137 137 137 137 137 
147 147 147 147 147 147 147 147 147 147 147 147 147 147 147 147 147 147 147 147 147 147 147 147 147 147 147 147 147 147 
172 172 172 172 172 172 172 172 172 172 172 172 172 172 172 172 172 172 172 172 172 172 172 172 172 172 172 172 197 197 
220 220 220 220 220 220 220 220 220 220 220 220 220 220 220 220 220 220 220 220 220 220 220 220 220 220 220 220 220 220 
230 230 230 230 230 230 230 230 230 230 230 230 230 230 230 230 230 230 230 230 230 239 240 240 240 243 243 243 243 243 
251 251 251 251 251 251 251 251 251 251 251 251 251 251 251 251 251 251 251 251 259 259 259 259 259 259 259 259 259 259 
0 0 0 0 0 0 0 251 0 0 0 0 0 0 251 251 0 0 0 0 0 259 259 0 0 0 0 0 0 0 
