1 1 1 1 1 1 7 7 7 7 
11 11 11 11 11 11 11 11 16 16 
18 18 18 18 18 18 18 18 18 18 
18 18 18 18 18 18 18 18 18 18 
26 26 26 26 26 26 26 26 26 26 
26 26 26 26 26 26 26 26 26 26 
37 37 26 26 26 26 26 26 26 26 
37 37 42 42 42 42 42 42 42 42 
37 37 42 42 42 42 42 42 42 50 
37 37 42 0 42 0 0 42 42 50 
