1 2 3 4 4 6 6 6 9 10 
1 2 3 4 4 4 4 11 9 10 
1 1 3 4 4 4 4 4 9 10 
12 12 12 13 14 4 4 15 15 15 
12 12 16 13 14 14 14 15 15 15 
17 17 16 16 16 16 18 18 20 15 
17 21 21 21 21 21 18 18 20 15 
25 25 24 25 25 25 25 25 20 20 
26 26 26 26 27 28 28 26 26 26 
26 0 26 0 27 28 28 0 26 26 
