1 1 1 1 1 6 6 6 6 6 6 6 6 6 6 6 6 6 6 6 21 21 23 23 23 23 27 27 27 27 
31 32 32 32 32 6 6 6 6 6 6 6 6 6 6 6 6 6 6 45 45 45 45 45 48 48 48 48 48 48 
31 31 31 31 51 51 53 53 53 53 53 53 53 53 53 53 60 61 61 61 61 61 61 61 61 61 61 61 61 61 
31 31 31 31 31 71 71 75 75 75 75 75 75 75 75 75 60 60 60 60 60 60 82 83 83 83 83 83 83 83 
88 89 89 89 89 89 89 89 89 93 94 94 94 94 94 96 96 96 96 96 96 96 96 96 96 103 103 83 83 106 
88 88 88 109 109 109 109 109 109 109 109 94 94 115 115 115 115 115 115 115 115 115 115 115 115 115 115 115 115 115 
125 125 125 131 131 131 131 130 131 131 131 131 131 131 134 134 134 134 134 134 134 134 134 134 134 134 134 134 134 145 
146 125 125 131 131 131 131 131 131 150 150 131 131 131 131 131 131 131 131 131 131 131 131 131 131 131 131 131 131 131 
146 172 172 172 172 172 172 172 172 172 172 172 172 172 172 172 172 172 172 172 172 172 172 172 172 172 172 172 172 172 
146 146 146 146 146 146 146 146 146 146 146 146 146 146 146 146 146 146 146 146 146 146 198 198 198 201 202 202 202 202 
206 206 206 206 206 206 215 215 213 213 215 215 216 216 218 215 215 215 215 215 223 215 215 225 198 198 198 198 198 198 
236 236 236 236 236 236 236 236 236 236 236 235 235 236 236 236 236 236 236 236 236 236 236 236 236 236 243 243 243 243 
268 268 268 268 268 268 268 268 268 268 268 268 268 268 268 268 268 268 268 268 268 268 268 268 268 268 268 268 268 268 
274 274 274 274 274 274 274 274 274 274 274 274 274 274 274 274 274 274 274 274 274 286 286 274 288 288 288 288 288 288 
274 0 274 0 0 274 0 0 0 0 0 0 0 0 0 274 274 0 0 0 274 0 286 0 0 0 0 288 0 288 
