1 1 1 4 5 6 7 7 7 7 11 11 11 11 11 
16 17 1 1 5 5 5 5 5 5 21 21 22 23 24 
16 16 1 1 1 1 1 29 30 5 31 31 22 23 23 
32 32 33 1 34 35 35 29 29 29 29 37 37 37 38 
32 32 33 1 34 34 40 29 29 29 43 44 37 37 38 
32 46 33 1 1 1 40 40 40 40 40 40 50 37 37 
32 32 32 32 32 32 32 54 55 40 40 57 50 50 37 
59 60 61 62 32 63 64 64 55 55 55 57 50 66 66 
59 60 60 60 32 63 63 67 67 68 68 57 50 66 66 
59 59 59 59 32 32 32 74 67 68 68 57 57 57 57 
77 77 79 59 32 80 81 81 67 67 68 68 68 85 57 
77 86 86 86 32 32 32 32 32 32 32 89 89 89 57 
77 77 77 77 32 93 94 95 95 95 98 98 89 100 57 
101 102 102 102 102 93 93 104 105 95 98 106 106 106 57 
101 0 0 0 102 93 0 104 105 95 98 106 0 0 57 
