1 2 2 2 5 5 5 5 5 10 11 11 13 13 15 
1 1 16 17 17 17 17 17 19 19 19 20 21 21 21 
1 1 16 16 16 16 16 16 16 19 24 24 21 21 21 
1 1 1 1 1 29 30 16 16 16 16 16 21 31 32 
33 35 35 35 35 36 36 36 36 36 36 36 21 21 21 
38 38 38 38 38 38 42 41 42 42 42 42 42 42 42 
41 41 41 41 41 41 41 41 41 41 41 41 41 41 47 
54 54 54 54 54 52 54 54 54 54 54 55 54 56 56 
54 54 54 54 54 54 54 54 60 54 61 55 55 55 55 
63 63 63 64 65 65 63 63 60 70 70 70 70 70 70 
71 71 71 71 71 71 63 63 60 70 70 70 70 70 75 
76 76 76 76 76 76 63 63 60 77 77 77 77 77 75 
79 79 79 79 79 79 79 79 79 84 84 84 84 84 75 
86 86 86 86 86 86 90 86 91 92 92 93 94 95 95 
0 86 0 86 86 0 90 0 91 92 0 93 94 95 95 
